type octile
height 6
width 9
map
...@@@...
..@@@@@..
.@@@@@@@.
..@@@@@..
...@@@...
.........