type octile
height 8
width 5
map
........
........
.....@..
.....@..
.....@..