.............................
.............................
...@@@@@@@@@@@@@@@@@@@@@@@@..
..........................@..
..........................@..
..........................@..
..........................@..
.................@........@..
..........................@..
..........................@..
..........................@..
..........................@..
..........................@..
..........................@..
..........................@..
..........................@..
..........................@..
..........................@..
..........................@..
..........................@..
..........................@..
..........................@..
..........................@..
..........................@..
..........................@..
..........................@..
..........................@..
...@@@@@@@@@@@@@@@@@@@@@@@@..
.............................
.............................