...@......
@..@...@..
..@@....@.
.@..@@..@.
........@.
@@@@@@@@..
..........
...@......
....@@@@@@
..........