.......................................
..................................@@@@@
.................................@@@@@@
.......................................
................................@@@@@@.
..............................@@@@@@@..
.............................@@@@@@@@..
..............................@@@@@@@..
...............................@@@@@@@.
...............................@@@@@@@.
...............................@@@@....
............................@@@@@@@@...
................@@@@........@@@@@@@@...
@............@@@@@@@.........@@@@@@@...
@............@@@@@@@.........@@@@@@@@@.
@@...........@@@@@@@@........@@@@@@@@@.
@@............@@@@@@@..........@@@@@@@.
@@............@@@@@@@..........@@@@@@@@
@@@@.........@@@@@@@............@@@@@@@
@@@@........@@@@@@@@............@@@@@@@
@@@@........@@@@@@@@............@@@@@@@
@@@@@.......@@@@@@@@@...........@@@@@@@
@@@@@........@@@@@@@@...........@@@@@@@
@@@@@........@@@@@@@@...........@@@@@@@
@@@@@........@@@@@@@@............@@@@@@
@@@@@........@@@@@@@@............@@@@@@
@@@@@@........@@@@@@@...........@@@@@@@
@@@@@@........@@@@@@@@........@@@@@@@..
@@@@@@........@@@@@@@@........@@@@@@@..
@@@@@@........@@@@@@@@.......@@@@@@@...
@@@@@@@........@@@@@@@......@@@@@@@....
@@@@@@@........@@@@@@@.....@@@@@@@.....
@@@@@@@........@@@@@@@@...@@@@@........
@@@@@@@........@@@@@@@@..........@@@...
@@@@@@@........@@@@@@@@......@@@@@@@...
@@@@@@@.........@@@@@@@......@@@@@@@@..
@@@@@@@@........@@@@@@@......@@@@@@@...
.@@@@@@@........@@@@@@@...@@@@@@@@@@@..
.@@@@@@@........@@@@@@@.@@@@@@@@@@@@...
..@@@@@@@........@@@@@@@....@@@@@@@@@...